########
#A#    #
# ## # #
#    #B#
########