##############################
#A   #       #       #      ##
# ### ##### ### ### ##### # ##
#   #   #   #   #   #   # #  #
### ### # ######### # # # ###
#   #   #     #   # # #     #
# # ##### ### ### # # ##### #
# #     #   #   # # # #   # #
### ### ### ### # # # # # ###
#   # #   #     # #   # #   #
# ### # ######### ##### ### #
#   # #   #     #     # #   #
# # # ### # ### ##### # # ###
# #     #     #     #   #  B#
##############################
