###############
#A  #     #   #
# # # ### # # #
# # #   # # # #
# ##### # # # #
#     # # #   #
##### # # ##### 
#   # #     # #
# # # ##### # #
# #   #   #   #
# ##### # ##### 
#     # #     #
##### # #######
#     #     B #
###############
