####################
#A   #        #    #
# #  #  ####  #  # #
# #     #     #  # #
# #######  ####  # #
#        #       # #
###### # ####### # #
#    # #       #   #
# ## # ##### #   ###
#    #     #   #   B
####################
